NO ./img/teapot.xpm
SO ./img/teapot.xpm
WE ./img/teapot.xpm
EA ./img/teapot.xpm

F 58,61,56
C 115,191,249

1111111
1000001
1000001
100S001
1000001
1000001
1000001
1000001
1000001
100N001
1000001
1000001
1000001
1000001