NO ./img/xpm/128/square_1.xpm
SO ./img/xpm/128/square_2.xpm
WE ./img/xpm/128/square_5.xpm
EA ./img/xpm/128/square_4.xpm

F 180,180,180
C 53,53,53

11111
10001
1N001
11111