NO ./img/xpm/128/square_1.xpm
SO ./img/xpm/128/square_2.xpm
WE ./img/xpm/128/square_5.xpm
EA ./img/xpm/128/square_4.xpm

F 180,180,180
C 0,0,0

        1111111111111111111111111
        1000000000110000000000001
        1011000001110000000000001
        1001000000000000000000001
111111111011000001110000000000001
100000000011000001110111111111111
11110111111111011100000010001
11110111111111011101010000001
11000000110101011100000010N01
10000000000000001100000010001
10000000000000001101010010001
11000001110101011111011110001
11110111 1110101 101111010001
11111111 1111111 111111111111